#######################
#X  ++++++  O   #     #
# #+# #+#+#+# # #     #
# ++  ++++ ++   # O   #
#+#+# #+#+# # # #     #
#+ O  ++++ O   +#  O  #
# # # # #+# # #+#     #
#  O   ++++ ++++#     #
# # # #+# #+#+#+#  O  #
#    O++++++    #     #
# #+#+#+# #+# # #     #
#  +++++  + +  X# O   #
#                     #
#             O       #
#         +  +      ###
#######################
270
