#################
#X  ++++++  O   #
# #+# #+#+#+# # #
# ++  ++++ ++   #
#+#+# #+#+# # # #
#+ O  ++++ O   +#
# # # # #+# # #+#
#  O   ++++ ++++#
# # # #+# #+#+#+#
#    O++++++    #
# #+#+#+# #+# # #
#  +++++  + +  X#
#################
470